Occupancy grid/map used for pathfinding and navigation

Legend:
	0: Boundary/border
	1: Obstacle/occupied square
	2: Dialated obstacle locations
	3: Navigated path in search of a route
	4: Waypoints
	5: Starting location

0 0 0 0 0 0 0 0 0 0 0 0 0 0 0 0 0 0 0 0 0 0 0 0 0 0 0 0 0 0 0 0 0 0
0     2 1 1 1 1 1 1 1 2                                           0
0     2 1 1 1 1 1 1 1 2                                           0
0     2 1 1 1 1 1 1 1 2       2 2 2 2               4 3 3 3 4     0
0       2 1 1 1 1 1 1 2     2 1 1 1 1 2           3               0
0         2 2 2 2 2 2       2 1 1 1 1 1 2       3                 0
0                           2 1 1 1 1 1 2     3                   0
0             2 2 2 2       2 1 1 1 1 1 2   3                     0
0           2 1 1 1 1 2     2 1 1 1 1 1 2 3                       0
0           2 1 1 1 1 2       2 2 2 2 2 3       2 2               0
0           2 1 1 1 1 2         4 3 3 4       2 1 1 2 2           0
0           2 1 1 1 1 2       3             2 1 1 1 1 1 2         0
0           2 1 1 1 1 2     3 2 2 2 2 2 2 2 2 1 1 1 1 1 2         0
0             2 2 2 2     4 2 1 1 1 1 1 1 1 1 1 1 1 1 1 2 2 2 2 2 0
0                         3 2 1 1 1 1 1 1 1 1 1 1 1 1 1 1 1 1 1 1 0
0                         3 2 1 1 1 1 1 1 1 1 1 1 1 1 1 1 1 1 1 1 0
0                         3 2 1 1 1 1 1 1 1 1 1 1 1 1 1 1 1 1 1 1 0
0         2 2 2 2         4 2 1 1 1 1 1 1 1 1 1 1 1 1 1 1 1 1 1 1 0
0       2 1 1 1 1 2         4 2 2 2 2 2 2 1 1 1 1 1 1 1 1 1 1 1 1 0
0       2 1 1 1 1 2         4             2 2 2 2 2 2 2 2 2 2 2 2 0
0       2 1 1 1 1 2       3                                       0
0       2 1 1 1 1 2     3   2 2 2 2 2 2 2 2                       0
0       2 1 1 1 1 2   3   2 1 1 1 1 1 1 1 1 2                     0
0       2 1 1 1 1 2 3     2 1 1 1 1 1 1 1 1 2                     0
0         2 2 2 2 3       2 1 1 1 1 1 1 1 1 2                     0
0               3         2 1 1 1 1 1 1 1 1 2                     0
0             3           2 1 1 1 1 1 1 1 2       2 2 2 2 2 2 2 2 0
0           3               2 2 2 2 2 2 2       2 1 1 1 1 1 1 1 1 0
0         5                                     2 1 1 1 1 1 1 1 1 0
0                                               2 1 1 1 1 1 1 1 1 0
0                                               2 1 1 1 1 1 1 1 1 0
0                                               2 1 1 1 1 1 1 1 1 0
0                                               2 1 1 1 1 1 1 1 1 0
0 0 0 0 0 0 0 0 0 0 0 0 0 0 0 0 0 0 0 0 0 0 0 0 0 0 0 0 0 0 0 0 0 0

